11111111111111111111111
11C10C0E000C11110000011
101000P0001111111111111
101M0000000011111111111
11111101111111111111111
1100M000000000111111111
11111110000111111111111
11111100000000111111111
1111111000C000111111111
11000000111111111111111
11000010011111111111111
111110M0000000000111111
11111111111111111111111