1111111111111111111111
100100P0000C1111111111
10E00000P0001111111111
1111111111111111111111
1111111111111111111111